NO ./xpm_files/north.xpm
SO ./xpm_files/south.xpm
C 131,  217  ,254
EA ./xpm_files/west.xpm

F      200,200, 200
WE ./xpm_files/east.xpm

        1111111111111111111111111
        1000000000110S00000000001
        1011000001110000000000001
        1001000000000000000000001
111111111011000001110000000000001
100000000011000001110111110111111
11110111111111011100000010001
11110111111111011101000010001
11000000110101011100000010001
10000000000000001100000010001
10000000000000001101000010001
1100000111010101111101111000111
11110111 1110101 101111010001
11111111 1111111 111111111111

