NO ./xpm_files/Blue_Brick.xpm
SO ./xpm_files/Rusty.xpm
C 42, 72, 82
EA ./xpm_files/metal_walls_crop.xpm

F      84, 90, 92
WE ./xpm_files/Pilier_Center.xpm

        1111111111111111111111111
        100000000011000000000001
        10110000011100000S0000001
        1001000000000000000000001
111111111011000001110000000000001
100000000011000001110111110111111
11110111111111011100000010001
11110111111111011101000010001
11000000110101011100000010001
10000000000000001100000010001
10000000000000001101000010001
1100000111010101111101111000111
11110111 1110101 101111010001
11111111 1111111 111111111111
11