NO ./path_to_the_north_texture.xpm
SO ./path_to_the_south_texture.xpm
C 225,  30  ,0
EA ./path_to_the_east_texture.xpm

F      220,100, 0
WE ./path_to_the_west_texture.xpm

1111111111111111111111111111111
1000000000000000000000000000001
1000000000000000000000000000001
1000000000000000000000000000001
1000000000000000000000000000001
1000000000000000000000000000001
10000000000000S0000000000000001
1000000000000000000000000000001
1000000000000000000000000000001
1000000000000000000000000000001
1000000000000000000000000000001
1111111111111111111111111111111